000000000000000
000000000000000
000000000000000
282233113322820
303000000003030
003000000003000
003001133003000
001001133001000
001001223001000
002001223002000
002001133002000
003001133003000
003000000003000
001000000001000
002113333112000
