000000000000000
080000000000080
008123454321800
003800000008300
004081111180400
005013333310500
006013666310600
007013686310700
006013666310600
005013333310500
004081111180400
003800000008300
008123454321800
080000000000080
000000000000000
