000000000000000
000000000000000
111100111001111
222200222002222
333300333003333
444400444004444
333300333003333
222200222002222
111100111001111
000000000000000
000000000000000
000000000000000
000000000000000
000000000000000
000000000000000
