000000080000000
008000080000800
000000666000000
008000676000800
000000676000000
008002444200800
008002444200800
008222332222800
008223333522800
000088000880000
000000010000000
000000141000000
000001484100000
000001484100000
000014505410000
