000044000000000
000340000000000
003300005500000
003300025000000
013340025000000
013344020000000
143344220000000
143344220000000
113344020000000
013340020000000
013344025000000
003300025000000
003300005500000
003300000000000
000040000000000
