000080000800000
080000000000800
000011661100000
000811661180000
801177667711080
001177667711000
006666546666000
006666456666000
001177667711000
801177667711080
000811661180000
000011661100000
080000000000800
000080000800000
000000000000000
