000000000000000
000000000000000
000000010000000
000000222000000
000003333300000
000011111110000
000222222222000
003333333333300
000222222222000
000011111110000
000003333300000
000000222000000
000000010000000
000000000000000
000000000000000
