000000000000000
011000000001100
010100000010100
000011111100000
000112222110000
000122222210000
000128228210000
000122222210000
000122882210000
000122222210000
000012112100000
000001001000000
000001001000000
000001001000000
000011001100000
