100000000000000
120000000000000
123000000000000
123400000000000
123450000000000
123456000000000
123456700000000
123456710000000
123456712000000
123456712300000
123456712340000
123456712345000
123456712345600
123456712345670
123456712345671
